XXXXXXXXXX-XXXXXXXXXXXXXXXXXXXXXXXXXXXXX
X                                      X
X                                      X
X                                      X
X                                   S XX
X      $S X                            X
X                   *                  X
X                                      X
X J                                    X
X                 $                    X
X                                      X
X                                      X
X                                      X
X                                      X
X                                      X
X                                      X
X                                      X
X                                      X
X                                      X
XXXXXXXXXXXXXXXXXXXXX-XXXXXXXXXXXXXXXXXX
